12 x 12
0   0 0 0 0 0 0 0 0 0 0 16 
16 16 16 0 16 0 16 16 16 16 0 0 
0 0 0 0 16 32 16 0 0 16 0 0 
32 0 0 0 16 32 16 0 0 16 0 0 
0 0 0 0 16 32 16 0 0 16 0 0 
0 0 0 0 16 16 16 0 0 16 0 0 
0 0 0 0 0 0 0 0 0 16 0 0 
0 17 32 17 0 0 0 0 0 16 0 0 
0 17 17 17 0 0 0 0 0 16 0 0 
0 0 0 0 0 0 0 0 0 16 0 0 
0 16 16 16 16 16 16 16 16 16 37 0 
0 48 49 0 0 0 0 0 0 0 0 0 
