13 x 14
0 0 0 0 0 0 0 0 0 0 0 17 17 
17 17 17 0 17 0 17 17 17 17 0 0 17  
0 0 0 0 17 32 17 0 0 17 0 0 17 
32 0 0 0 17 32 17 0 0 17 0 0 17 
0 0 0 0 17 32 17 0 0 17 0 0 17 
0 0 0 0 17 17 17 0 0 17 0 0 17 
0 0 0 0 0 0 0 0 0 17 0 0 17 
0 17 32 17 0 0 0 0 0 17 0 0 17 
0 17 17 17 0 0 0 0 0 17 0 0 17 
0 0 0 0 0 0 0 0 0 17 0 0 17 
0 17 16 16 17 17 17 17 17 17 37 0 17  
0 0 0 0 0 0 0 0 0 0 0 0 17 
0 0 0 0 0 0 0 0 0 0 0 0 17 
0 0 0 0 0 0 0 0 0 0 0 0 17 
