Size: 20 x 8
Background : R=242, G=238, B=186
Pop coords: 0 ; 0
0  0 96 17 0 38 16 16 0  0 0 0 17 0 0 0 0 0 17 17 
0  0 0  17 0 0  0  0  16 0 0 0 17 0 96 0 0 16 16 16 
0  0 0  17 0 0  16 0  16 0 0 0 38 0 0 0 0 0 18 
0  0 0  0 37 0  16 37 35 0 0 0 17 0 96 0 16 16 16 
51 0 0  17 0 0  16 35 16 0 0 0 17 0 0 0 0 0 17 17 
0 0 0  17 0 0  16 0 16 0 0 0 17 0 0 0 0 0 17 17 
0 0 0  17 0 0  16 0 16 0 0 0 17 0 0 0 0 0 17 17 
0 0 0  17 0 0  16 0 16 0 0 0 17 0 0 0 0 0 17 17 
