13 x 14
10 ; 2
0 0 0 0 0 0 0 0 0 0 0 17 17 
17 17 17 0 17 0 17 17 17 17 0 0 17  
0 0 0 0 17 32 17 0 0 17 0 0 17 
32 0 0 0 17 32 17 0 0 17 0 0 17 
0 0 0 0 17 32 17 0 0 17 0 0 17 
0 0 0 0 17 17 17 0 0 17 0 0 17 
0 0 0 0 0 0 0 0 0 17 0 0 17 
0 17 32 17 0 0 0 0 0 17 0 0 17 
0 17 17 17 0 0 0 49 0 17 0 0 17 
0 0 0 0 0 0 0 0 0 17 0 0 17 
0 17 16 16 17 17 17 17 17 17 37 0 17  
0 0 0 0 0 0 0 0 0 0 0 0 17 
0 0 0 0 0 0 0 0 0 0 0 0 17 
0 0 0 0 0 0 0 0 0 18 0 0 17 
