12 x 12
2 ; 0
0   0 0 0 0 0 0 0 0 0 0 16 
16 16 16 0 16 0 16 16 16 16 0 0 
0 0 0 0 16 35 16 0 0 16 0 0 
34 0 0 0 16 36 16 0 0 16 0 0 
0 0 0 0 16 37 16 0 0 16 0 0 
0 0 0 0 16 16 16 0 0 16 0 0 
0 0 0 0 0 0 0 0 0 16 0 0 
0 17 33 17 0 0 0 0 0 16 0 0 
0 17 17 17 0 64 0 0 0 16 0 0 
0 0 0 0 0 0 0 0 0 16 0 0 
0 16 16 16 16 16 16 16 16 16 38 0 
0 0 50 0 0 0 0 0 0 0 0 0 
